1111111111111111
100000000E000001
100000C00E000001
10000PC11E000C01
100000C00E000001
100000000E000001
1111111111111111
