1111111111111111
1000X00000000001
1000000C0000X001
10000P1C1000C001
1000000E00000001
100000P00000E001
1111111111111111
