1111111111111111111111111111111111
1ECP000000000000000000000000X00001
1010010100100000101001000000010101
1010010010101010001001000000X10101
1000000000000000000000X00000000001
1111111111111111111111111111111111
