1111111111111111
1000000000000001
100000C000000001
10000PC110000C01
100000C000000001
100000000000E001
1111111111111111
