1111111111111111
1P0000000E0000P1
100000C00E000001
100000C11E000C01
100000C00E000001
1P0000000E000001
1111111111111111
